{
    "Intersection_A": {
        "7027": 1,
        "7025": 2,
        "7023": 3,
        "7021": 4, 
        "7019": 5,
        "7017": 5,
        "7015": 4,
        "7011": 1,
        "7029": 1,
        
        "7201": 1,
        "7203": 2,
        "7205": 3,

        "7012": 1,
        "7010": 2,
        "7008": 3,
        "7006": 4,
        "7004": 5,
        "7002": 6,
        "7001": 6,
        "7003": 5,
        "7005": 4,
        "7007": 3,
        "7009": 2,
        "Intersection_B": 4
    },

    "Intersection_B": {
        "7205": 1,
        "7203": 2,
        "7201": 3,
        "7029": 4, 
        "Intersection_A": 4,

        "7207": 1,
        "7108": 2,
        "7103": 2,
        "7105": 3,

        "Intersection_C": 3,
        "Intersection_H": 2
    },

    "Intersection_H": {
        "7207": 1,

        "Intersection_B": 2,
        "Intersection_F": 5,
        "7210": 1,
        "7211": 2,
        "7213": 3,
        "7215": 4,
        "7218": 4,
        "7217": 5,
        "Intersection_E": 6
    },

    "Intersection_E": {
        "7217": 1,
        "7215": 2,
        "7218": 2,
        "7213": 3,
        "7211": 4,
        "7210": 5,
        "Intersection_H": 6,

        "7219": 1,
        "7221": 2,
        "7223": 1,
        "7225": 2,
        "7227": 3,
        "7224": 1,
        "Intersection_F": 4
    },

    "Intersection_F": {
        "7227": 1,
        "7225": 2,
        "7223": 3,
        "7224": 3,
        "Intersection_E": 4,

        "7128": 1,
        "7129": 1,
        "7127": 2,
        "7126": 2,
        "7125": 3,
        "7123": 4,
        "7121": 5,
        "7122": 5,
        "7119": 6,
        "7117": 7,
        "Intersection_D": 7,
        "Intersection_G": 7
    },

    "Intersection_D": {
        "7117": 1,
        "7119": 2,
        "7122": 2,
        "7121": 2,
        "7123": 3,
        "7125": 4,
        "7126": 4,
        "7127": 5,
        "7129": 6,
        "7128": 6,
        "Intersection_F": 7,
        "7115": 2,
        "7113": 3,
        "7111": 2,
        "7114": 3,
        "7112": 4,
        "7110": 5,
        "7108": 6,
        "7105": 7,
        "7103": 7,
        "Intersection_C": 7
    },

    "Intersection_C": {
        "7105": 1,
        "7103": 1,
        "7101": 3,
        "7108": 2,
        "7208": 3,
        "Intersection_B": 4,
        "7110": 2,
        "7112": 3,
        "7114": 5,
        "7111": 6,
        "Intersection_D": 7
    },

    "Intersection_G": {
        "Intersection_F": 7,
        "Intersection_M": 1,
        "7401": 1,
        "7403": 2,
        "7405": 3,
        "7407": 4,
        "7409": 5,
        "7411": 6,
        "7412": 6,
        "Intersection_N": 6
    },

    "Intersection_M": {
        "Intersection_I": 4,
        "Intersection_G": 1,
        "7601": 1,
        "7603": 2,
        "7604": 2,
        "7605": 3,
        "7607": 5,
        "7609": 6,
        "Intersection_K": 6
    },

    "Intersection_K": {
        "7609": 1,
        "7705": 1,
        "7707": 2,
        "7703": 2,
        "7701": 2,
        "Intersection_J": 3,
        "Intersection_L": 2,
        "7607": 2,
        "7605": 3,
        "7603": 4,
        "7601": 5,
        "7604": 4,
        "Intersection_M": 6
    },

    "Intersection_J": {
        "7701": 1,
        "7703": 2,
        "Intersection_K": 3,
        "7517": 1,
        "7515": 2,
        "7513": 3,
        "7511": 4,
        "7509": 5,
        "7507": 6,
        "7505": 7,
        "Intersection_I": 7
    },

    "Intersection_I": {
        "7501": 2,
        "7503": 1,
        "7505": 1,
        "7507": 2,
        "7509": 3,
        "7511": 4,
        "7513": 5,
        "7515": 6,
        "Intersection_J": 6,
        "Intersection_M": 5
    },

    "Intersection_L": {
        "Intersection_K": 1,
        "7707": 1,
        "7709": 1,
        "7711": 2,
        "7713": 3,
        "7715": 4,
        "7717": 5,
        "7412": 5,
        "Intersection_O": 5
    },

    "Intersection_O": {
        "7412": 1,
        "7717": 1,
        "7715": 2,
        "7713": 3,
        "7711": 4,
        "7708": 5,
        "7709": 6,
        "Intersection_L": 7,
        "7719": 1,
        "7721": 2,
        "7723": 3,
        "7725": 3,
        "7416": 1,
        "7414": 2,
        "Intersection_N": 3
    },

    "Intersection_N": {
        "7412": 1,
        "7414": 1,
        "7416": 2,
        "Intersection_O": 3,
        "7411": 1,
        "7413": 2,
        "7415": 3,
        "7409": 2,
        "7407": 3,
        "7405": 4,
        "7403": 5,
        "7401": 6,
        "Intersection_G": 7,
        "7404": 4
    }





}
