{
    "6I": {
        "6501": 1,
        "6503": 1,
        "6505": 2,
        "6507": 3,
        "6509": 3,
        "6G": 3,
        "6J": 6
    },
    "6J": {
        "6515": 1,
        "6513": 2,
        "6511": 3,
        "6509": 4,
        "6507": 5,
        "6505": 6,
        "6503": 7,
        "6I": 7,
        "6701": 1,
        "7603": 2
    },
    "6K": {
        "6703": 1,
        "7601": 2,
        "6705": 1,
        "6707": 2,
        "6709": 3,
        "6711": 4,
        "6713": 5,
        "6609": 1,
        "6607": 2,
        "6605": 3,
        "6603": 4,
        "6601": 5,
        "6604": 3,
        "6602": 5,
        "6G": 6,
        "6708": 4
    },
    "6O": {
        "6715": 1,
        "6713": 2,
        "7611": 3,
        "6709": 4,
        "6707": 5,
        "6705": 6,
        "6K": 6,
        "6717": 1,
        "6719": 2,
        "6721": 3,
        "6716": 1,
        "6418": 2,
        "6412": 3,
        "6416": 1,
        "6414": 2,
        "6N": 3,
        "6708": 7
    },
    "6N": {
        "6416": 2,
        "6414": 1,
        "6412": 1,
        "6418": 2,
        "6417": 2,
        "6415": 1,
        "6413": 1,
        "6411": 2,
        "6409": 3,
        "6407": 4,
        "6405": 5,
        "6403": 6,
        "6501": 7,
        "6404": 5,
        "6O": 3,
        "6G": 7
    },
    "6G": {
        "6I": 2,
        "6K": 5,
        "6N": 6,
        "6F": 5
    },
    "6F": {
        "6G": 5,
        "6E": 4,
        "6C": 4,
        "6D": 4
    },
    "6D": {
        "6F": 4,
        "6121": 1,
        "6119": 2,
        "6117": 1,
        "6115A": 2,
        "6113": 3,
        "6A": 3
    },
    "6A": {
        "6113": 1,
        "6115A": 2,
        "6D": 3,
        "6103": 2,
        "6111": 2,
        "6109": 2,
        "6107": 2,
        "6B": 3
    },
    "6B": {
        "6102": 1,
        "6105": 2,
        "6A": 3,
        "6C": 4
    },
    "6C": {
        "6B": 4,
        "6F": 6,
        "6E": 8,
        "6Y": 7,
        "6210": 1,
        "6211": 2,
        "6213": 3,
        "6215": 4,
        "6217": 6,
        "6218": 5,
        "6207": 1,
        "6205": 2,
        "6203": 3,
        "6201": 4
    },
    "6E": {
        "6227": 3,
        "6225": 2,
        "6223": 1,
        "6219": 1,
        "6221": 2,
        "6217": 2,
        "6215": 3,
        "6213": 4,
        "6220": 1,
        "6218": 2,
        "6211": 5,
        "6C": 6,
        "6F": 3
    },
    "6Y": {
        "6012": 1,
        "6029": 2,
        "6027": 2,
        "6025": 1,
        "6023": 2,
        "6W": 2,
        "6X": 2,
        "6201": 3,
        "6203": 4,
        "6205": 5,
        "6207": 6,
        "6C": 6 
    },
    "6W": {
        "6Y": 2,
        "6011": 1,
        "6021": 1,
        "6019": 2,
        "6017": 3,
        "6015": 3,
        "6013": 2
    },
    "6X": {
        "6Y": 1,
        "6009": 1,
        "6010": 1,
        "6008": 2,
        "6007": 2,
        "6006": 3,
        "6005": 3,
        "6004": 4,
        "6003": 4,
        "6002": 5,
        "6001": 6
    }
}