{
    "A": {
        "7027": 1,
        "7025": 2,
        "7023": 3,
        "7021": 4, 
        "7019": 5,
        "7017": 5,
        "7015": 4,
        "7011": 1,
        "7029": 1,
        
        "7201": 1,
        "7203": 2,
        "7205": 3,

        "7012": 1,
        "7010": 2,
        "7008": 3,
        "7006": 4,
        "7004": 5,
        "7002": 6,
        "7001": 6,
        "7003": 5,
        "7005": 4,
        "7007": 3,
        "7009": 2,
        "B": 4
    },

    "B": {
        "7205": 1,
        "7203": 2,
        "7201": 3,
        "7029": 4, 
        "A": 4,

        "7207": 1,
        "7108": 2,
        "7103": 2,
        "7105": 3,

        "C": 3,
        "H": 2
    },

    "H": {
        "7207": 1,

        "B": 2,
        "F": 5,
        "7210": 1,
        "7211": 2,
        "7213": 3,
        "7215": 4,
        "7218": 4,
        "7217": 5,
        "E": 6
    },

    "E": {
        "7217": 1,
        "7215": 2,
        "7218": 2,
        "7213": 3,
        "7211": 4,
        "7210": 5,
        "H": 6,

        "7219": 1,
        "7221": 2,
        "7223": 1,
        "7225": 2,
        "7227": 3,
        "7224": 1,
        "F": 4
    },

    "F": {
        "7227": 1,
        "7225": 2,
        "7223": 3,
        "7224": 3,
        "E": 4,

        "7128": 1,
        "7129": 1,
        "7127": 2,
        "7126": 2,
        "7125": 3,
        "7123": 4,
        "7121": 5,
        "7122": 5,
        "7119": 6,
        "7117": 7,
        "D": 7,
        "G": 7
    },

    "D": {
        "7117": 1,
        "7119": 2,
        "7122": 2,
        "7121": 2,
        "7123": 3,
        "7125": 4,
        "7126": 4,
        "7127": 5,
        "7129": 6,
        "7128": 6,
        "F": 7,
        "7115": 2,
        "7113": 3,
        "7111": 2,
        "7114": 3,
        "7112": 4,
        "7110": 5,
        "C": 7
    },

    "C": {
        "7105": 1,
        "7103": 1,
        "7101": 3,
        "7108": 2,
        "7208": 3,
        "B": 4,
        "7110": 2,
        "7112": 3,
        "7114": 5,
        "7111": 6,
        "D": 7
    },

    "G": {
        "F": 7,
        "I": 4,
        "7401": 1,
        "7403": 2,
        "7405": 3,
        "7407": 4,
        "7409": 5,
        "7411": 6,
        "7412": 6,
        "7601": 1,
        "7603": 2,
        "7604": 2,
        "7605": 3,
        "7607": 5,
        "7609": 6,
        "K": 6,
        "N": 6
    },

    "K": {
        "7609": 1,
        "7705": 1,
        "7707": 1,
        "7703": 2,
        "7701": 2,
        "J": 3,
        "L": 2,
        "7607": 2,
        "7605": 3,
        "7603": 4,
        "7601": 5,
        "7604": 4,
        "G": 6,

        "7709": 2,
        "7711": 2,
        "7713": 3,
        "7715": 4,
        "7717": 5,
        "7412": 5,
        "O": 5
    },

    "J": {
        "7701": 1,
        "7703": 2,
        "K": 3,
        "7517": 1,
        "7515": 2,
        "7513": 3,
        "7511": 4,
        "7509": 5,
        "7507": 6,
        "7505": 7,
        "I": 7
    },

    "I": {
        "7501": 2,
        "7503": 1,
        "7505": 1,
        "7507": 2,
        "7509": 3,
        "7511": 4,
        "7513": 5,
        "7515": 6,
        "J": 6,
        "G": 3
    },

    "O": {
        "7412": 1,
        "7717": 1,
        "7715": 2,
        "7713": 3,
        "7711": 4,
        "7708": 5,
        "7709": 6,
        "L": 7,
        "7719": 1,
        "7721": 2,
        "7723": 3,
        "7725": 3,
        "7416": 1,
        "7414": 2,
        "N": 3,
        "K": 7
    },

    "N": {
        "7412": 1,
        "7414": 1,
        "7416": 2,
        "O": 3,
        "7411": 1,
        "7413": 2,
        "7415": 3,
        "7409": 2,
        "7407": 3,
        "7405": 4,
        "7403": 5,
        "7401": 6,
        "G": 7,
        "7404": 4
    }





}
